S.P..W..
........
W...#...
#......W
...P....
......#G
