PPP#.....#.P.#
.......#.P..#.
.PP...........
.......W...G..
........#.....
....P..P...#P.
.....P#.....P.
..............
....#..P...#.#
....P#..P..#..
.....#..P.....
.#.......PPP..
#.#.P.........
P....S....#...
