#.....#...###W
.............P
....PP........
.....#.......G
.P......##..#.
.......P......
...##....#P...
..P......#P...
...........#..
.....#........
P....#........
...........S..
.........P...#
..P......P...#
